15 20
1
76777777777777777777
72222222222222444447
74444444442442444447
74444444400442244447
74444444400444244447
74444444444444244447
74444444444444244447
74444444444444222447
74000244444444442447
74050222244804442447
74000244244002222447
74444444244444224447
74444444244444244447
74422222222222244447
77777777777777777777
