15 20
1
76777777777777777777
72222222222222444447
74444444444442444447
74444444444442244447
74444444440044244447
74444444440022244447
74444444444444244447
74444444444444222447
74000444444444442447
74050444444444442447
74000444444444422447
74222444444444224447
74424444444444244447
74422222222222244447
77777777777777777777
