15 20
1
11111111111111111111
10000000000000000001
10003333300000000001
10004444400000000001
10000022222200000001
10000002222222000001
10000002211222200001
10000002211220000001
10000000522200000001
10000000000044400001
10000000004440000001
10000444444000000001
10000333300000000001
10000000000000000001
11111111111111111111
