15 20
1
76777777777777777777
70000000000000000007
70004444400000000007
70004444400000000007
70000022222200000007
70000002222222000007
70000002244222200007
70000002244220000007
70000000522200000007
70000000000044400007
70000000004440000007
70000444444000000007
70000444400000000007
70000000000000000007
77777777777777777777
